###############################
......#......O......#.........#
#.###.#.###########.#####.###.#
#...#...#...#.....#OO...#.#.#.#
#.#.###.#.#.#.#.#.#####.#O#O#.#
#.#.#...#.#.#.#.#.....#...#.#.#
#X#.#.###O#.###.#####.#####.#.#
#.#.#O.O#.#...#.....#O#...#O..#
#.#.#####.###X#.###.###.#.#.###
#.#O..#...#.#.#O..#.O...#.#.#.#
#####.#.###.#O#.#####.###.#.#.#
#.O..O#...O.#.#.#O..#...#.#.#.#
#.###.###.###.#.#.#.###.#.#.#.#
#.#.X...#.#...#.#.#.O.#.#.#O#.#
#.#####O#O#.###O#O###O#.#.#.#.#
#.....#O#.#.#.O.#.#.#.#X#.O.#.#
#.###.###.#O#####.#.#.#####.#.#
#.X.#...O.#...#...#.#..O..#.#.#
###.#########.#O###.#####.#.#.#
#.#.#.......#.#.#....O..#.#.#.#
#.#.#.#####X#.#.#####.#.#.#.#.#
#.#.#O.O..#.#O#.#...#.#O#.#O#.#
#O#.#####.###.#.#.#.#.#.#.#.#.#
#.#.......#...#.#.#..O#.#.#...#
#.#####.###.###.#O#####.#.###.#
#.O...#.#...#...#...#O..#..X#.#
#.#O###O#.###O#####O#######.#.#
#.#.X...#.....#O..#.X.#.....#.#
#.#############.#.###.#O#######
#.X.............#.....#......O#
###############################